0
xxxxxxxxxxxxxxxxxxxxxxxxxxxxxxxxxxxxx x
x            x             xx         x
xxx  xxx      x     x      x x        x
x      xxx           x     x  x       x
x     x     xxxxxxxxxx     x   x      x
x x    xx  xxxx xxx xx     x    x     x
x x   xxxxxx    xxx  x     x x  x     x
x          xx      x x     x x  x     x
xxx xxx x      xx  x x     x xxxx     x
xxx   x    x x  xx   x     x          x
x          x x  x    x    x     x     x
xxxxxxxxxxx x x    x x   x      x     x
x        x    x     xx  x  x    x     x
xxS  x      x      xxx      x   x   x x
xxxxxxxxxxxxxxxxxxxxxxxxxxxxxxxxxxxxxxx